AclI	AACGTT
HindIII	AAGCTT
FalI	AAGNNNNNCTT
SspI	AATATT
MluCI	AATT
PciI	ACATGT
AgeI	ACCGGT
Acc36I	ACCTGC
CsiI	ACCWGGT
MluI	ACGCGT
BceAI	ACGGC
HpyCH4IV	ACGT
HpyCH4III	ACNGT
BaeI	ACNNNNGTAYC
BsaXI	ACNNNNNCTCC
AflIII	ACRYGT
SpeI	ACTAGT
BmrI	ACTGGG
BglII	AGATCT
AfeI	AGCGCT
AluBI	AGCT
Eco147I	AGGCCT
BmcAI	AGTACT
Bsa29I	ATCGAT
EcoT22I	ATGCAT
AseI	ATTAAT
SmiI	ATTTAAAT
CspCI	CAANNNNNGTGG
MfeI	CAATTG
AarI	CACCTGC
BauI	CACGAG
AjiI	CACGTC
AcvI	CACGTG
AdeI	CACNNNGTG
AleI	CACNNNNGTG
PvuII	CAGCTG
AlwNI	CAGNNNCTG
FauNDI	CATATG
FaeI	CATG
MslI	CAYNNNNRTG
XcmI	CCANNNNNNNNNTGG
AccB7I	CCANNNNNTGG
BccI	CCATC
Bsp19I	CCATGG
BseYI	CCCAGC
Cfr9I	CCCGGG
LpnPI	CCDG
AciI	CCGC
Cfr42I	CCGCGG
AccBSI	CCGCTC
HapII	CCGG
Bme1390I	CCNGG
BtgI	CCRYGG
AsuC2I	CCSGG
AspA2I	CCTAGG
MnlI	CCTC
BbvCI	CCTCAGC
AbsI	CCTCGAGG
SbfI	CCTGCAGG
Bpu10I	CCTNAGC
AxyI	CCTNAGG
EcoNI	CCTNNNNNAGG
HpyAV	CCTTC
BciT130I	CCWGG
Eco130I	CCWWGG
BcgI	CGANNNNNNTGC
Ple19I	CGATCG
MreI	CGCCGGCG
AccII	CGCG
MauBI	CGCGCGCG
EagI	CGGCCG
Rsr2I	CGGWCCG
Bsh1285I	CGRYCG
Pfl23II	CGTACG
SgrDI	CGTCGACG
Esp3I	CGTCTC
Hpy99I	CGWCG
MspA1I	CMGCKG
SgeI	CNNG
MspJI	CNNR
SgrAI	CRCCGGYG
BfaI	CTAG
BspCNI	CTCAG
PaeR7I	CTCGAG
Eam1104I	CTCTTC
AcuI	CTGAAG
BspMAI	CTGCAG
BpmI	CTGGAG
DdeI	CTNAG
BfmI	CTRYAG
AflII	CTTAAG
BpuEI	CTTGAG
Ama87I	CYCGRG
PsrI	GAACNNNNNNTAC
AloI	GAACNNNNNNTCC
MboII	GAAGA
BbsI	GAAGAC
BarI	GAAGNNNNNNTAC
AjuI	GAANNNNNNNTTGG
Asp700I	GAANNNNTTC
Mva1269I	GAATGC
EcoRI	GAATTC
CseI	GACGC
AatII	GACGTC
PflFI	GACNNNGTC
BoxI	GACNNNNGTC
AhdI	GACNNNNNGTC
AasI	GACNNNNNNGTC
ArsI	GACNNNNNNTTYG
Ecl136II	GAGCTC
BseRI	GAGGAG
BplI	GAGNNNNNCTC
MlyI	GAGTC
HinfI	GANTC
Eco32I	GATATC
Bsp143I	GATC
PfeI	GAWTC
BbvI	GCAGC
BtsI	GCAGTG
BmsI	GCATC
PaeI	GCATGC
SrfI	GCCCGGGC
NmeAIII	GCCGAG
MroNI	GCCGGC
BglI	GCCNNNNNGGC
AsiSI	GCGATCGC
AspLEI	GCGC
PauI	GCGCGC
MteI	GCGCNGCGC
CciNI	GCGGCCGC
BisI	GCNGC
Cac8I	GCNNGC
HpyF10VI	GCNNNNNNNGC
AsuNHI	GCTAGC
LmnI	GCTCC
LguI	GCTCTTC
BlpI	GCTNAGC
Bsp1286I	GDGCHC
AclWI	GGATC
BamHI	GGATCC
BseGI	GGATG
BshFI	GGCC
FseI	GGCCGGCC
DinI	GGCGCC
AscI	GGCGCGCC
EciI	GGCGGA
BslFI	GGGAC
Bsp120I	GGGCCC
KflI	GGGWCCC
AspS9I	GGNCC
BmiI	GGNNCC
Acc65I	GGTACC
BsaI	GGTCTC
AsuHPI	GGTGA
BstPI	GGTNACC
AvaII	GGWCC
AccB1I	GGYRCC
BaeGI	GKGCMC
BsaHI	GRCGYC
BanII	GRGCYC
AfaI	GTAC
BssNAI	GTATAC
BciVI	GTATCC
SalI	GTCGAC
Alw26I	GTCTC
Alw44I	GTGCAC
BsgI	GTGCAG
AccI	GTMKAC
Hpy166II	GTNNAC
NmuCI	GTSAC
HpaI	GTTAAC
MssI	GTTTAAAC
HincII	GTYRAC
Alw21I	GWGCWC
ApoI	RAATTY
BstNSI	RCATGY
BsrFI	RCCGGY
MflI	RGATCY
BfoI	RGCGCY
CviJI	RGCY
EcoO109I	RGGNCCY
PpuMI	RGGWCCY
FspAI	RTGCGCAY
BstSNI	TACGTA
BspHI	TCATGA
Aor13HI	TCCGGA
PfoI	TCCNGGA
MmeI	TCCRAC
Bsp68I	TCGCGA
Hpy188I	TCNGA
Hpy188III	TCNNGA
XbaI	TCTAGA
FbaI	TGATCA
HpyCH4V	TGCA
Acc16I	TGCGCA
BalI	TGGCCA
Bsp1407I	TGTACA
MseI	TTAA
PacI	TTAATTAA
AanI	TTATAA
AsuII	TTCGAA
AgsI	TTSAA
DraI	TTTAAA
PspXI	VCTCGAGB
PcsI	WCGNNNNNNNCGW
BsaAI	YACGTR
AcoI	YGGCCR
