Name	Enzyme
AanI	TTATAA
AarI	CACCTGC
AasI	GACNNNNNNGTC
AatII	GACGTC
AbsI	CCTCGAGG
Acc16I	TGCGCA
Acc36I	ACCTGC
Acc65I	GGTACC
AccB1I	GGYRCC
AccB7I	CCANNNNNTGG
AccBSI	CCGCTC
AccI	GTMKAC
AccII	CGCG
AciI	CCGC
AclI	AACGTT
AclWI	GGATC
AcoI	YGGCCR
AcuI	CTGAAG
AcvI	CACGTG
AdeI	CACNNNGTG
AfaI	GTAC
AfeI	AGCGCT
AflII	CTTAAG
AflIII	ACRYGT
AgeI	ACCGGT
AgsI	TTSAA
AhdI	GACNNNNNGTC
AhlI	ACTAGT
AjiI	CACGTC
AjuI	GAANNNNNNNTTGG
AleI	CACNNNNGTG
AloI	GAACNNNNNNTCC
AluBI	AGCT
Alw21I	GWGCWC
Alw26I	GTCTC
Alw44I	GTGCAC
AlwNI	CAGNNNCTG
Ama87I	CYCGRG
Aor13HI	TCCGGA
ApaI	GGGCCC
ApoI	RAATTY
AscI	GGCGCGCC
AseI	ATTAAT
AsiSI	GCGATCGC
Asp700I	GAANNNNTTC
AspA2I	CCTAGG
AspLEI	GCGC
AspS9I	GGNCC
AsuC2I	CCSGG
AsuHPI	GGTGA
AsuII	TTCGAA
AsuNHI	GCTAGC
AvaII	GGWCC
AxyI	CCTNAGG
BaeGI	GKGCMC
BaeI	ACNNNNGTAYC
BalI	TGGCCA
BamHI	GGATCC
BanII	GRGCYC
BarI	GAAGNNNNNNTAC
BauI	CACGAG
BbsI	GAAGAC
BbvCI	CCTCAGC
BbvI	GCAGC
BccI	CCATC
BceAI	ACGGC
BcgI	CGANNNNNNTGC
BciT130I	CCWGG
BciVI	GTATCC
BfaI	CTAG
BfmI	CTRYAG
BfoI	RGCGCY
BglI	GCCNNNNNGGC
BglII	AGATCT
BlpI	GCTNAGC
BmcAI	AGTACT
Bme1390I	CCNGG
BmiI	GGNNCC
BmrI	ACTGGG
BmsI	GCATC
BoxI	GACNNNNGTC
BplI	GAGNNNNNCTC
BpmI	CTGGAG
Bpu10I	CCTNAGC
BpuEI	CTTGAG
Bsa29I	ATCGAT
BsaAI	YACGTR
BsaHI	GRCGYC
BsaI	GGTCTC
BsaXI	ACNNNNNCTCC
BseGI	GGATG
BseRI	GAGGAG
BseYI	CCCAGC
BsgI	GTGCAG
Bsh1285I	CGRYCG
BshFI	GGCC
BslFI	GGGAC
Bsp1286I	GDGCHC
Bsp1407I	TGTACA
Bsp143I	GATC
Bsp19I	CCATGG
Bsp68I	TCGCGA
BspCNI	CTCAG
BspHI	TCATGA
BspMAI	CTGCAG
BsrFI	RCCGGY
BssNAI	GTATAC
BstNSI	RCATGY
BstPI	GGTNACC
BstSNI	TACGTA
BtgI	CCRYGG
BtsI	GCAGTG
Cac8I	GCNNGC
CciNI	GCGGCCGC
Cfr42I	CCGCGG
Cfr9I	CCCGGG
CpoI	CGGWCCG
CseI	GACGC
CsiI	ACCWGGT
CspCI	CAANNNNNGTGG
CviJI	RGCY
DdeI	CTNAG
DinI	GGCGCC
DraI	TTTAAA
EagI	CGGCCG
Eam1104I	CTCTTC
EciI	GGCGGA
Ecl136II	GAGCTC
Eco130I	CCWWGG
Eco147I	AGGCCT
Eco32I	GATATC
EcoNI	CCTNNNNNAGG
EcoO109I	RGGNCCY
EcoRI	GAATTC
EcoT22I	ATGCAT
Esp3I	CGTCTC
FaeI	CATG
FalI	AAGNNNNNCTT
FauNDI	CATATG
FbaI	TGATCA
Fnu4HI	GCNGC
FseI	GGCCGGCC
FspAI	RTGCGCAY
HapII	CCGG
HincII	GTYRAC
HindIII	AAGCTT
HinfI	GANTC
HpaI	GTTAAC
Hpy166II	GTNNAC
Hpy188I	TCNGA
Hpy188III	TCNNGA
Hpy99I	CGWCG
HpyAV	CCTTC
HpyCH4III	ACNGT
HpyCH4IV	ACGT
HpyCH4V	TGCA
HpyF10VI	GCNNNNNNNGC
KflI	GGGWCCC
KroNI	GCCGGC
LguI	GCTCTTC
LmnI	GCTCC
MauBI	CGCGCGCG
MboII	GAAGA
MfeI	CAATTG
MflI	RGATCY
MluCI	AATT
MluI	ACGCGT
MlyI	GAGTC
MmeI	TCCRAC
MnlI	CCTC
MreI	CGCCGGCG
MseI	TTAA
MslI	CAYNNNNRTG
MspA1I	CMGCKG
MssI	GTTTAAAC
Mva1269I	GAATGC
NmeAIII	GCCGAG
NmuCI	GTSAC
PacI	TTAATTAA
PaeI	GCATGC
PaeR7I	CTCGAG
PauI	GCGCGC
PciI	ACATGT
PfeI	GAWTC
Pfl23II	CGTACG
PflFI	GACNNNGTC
PfoI	TCCNGGA
Ple19I	CGATCG
PpuMI	RGGWCCY
PspXI	VCTCGAGB
PvuII	CAGCTG
SalI	GTCGAC
SbfI	CCTGCAGG
SgrAI	CRCCGGYG
SgrDI	CGTCGACG
SmiI	ATTTAAAT
SrfI	GCCCGGGC
SspI	AATATT
XbaI	TCTAGA
XcmI	CCANNNNNNNNNTGG
